00000000000000000000X0X000
00000000X00000X00X0000X000
0000000XX000000000XX00000X
00000000X000X0000000000000
0000000X000000X0XXXX0000XX
0000X0000X000000X0X0000000
X00X0X000X00X0XXX000X00000
0000000X0000000X000000X000
00000000X000X00X00000X0X00
00000000X00X0000000X00X0X0
XXX0000X0000XX000000000000
00X000000X0X0X0000000000XX
X00X0X00XX0X000XX000000000
0000XXX0000000000000000000
0X000000000X00X00X00X0X0X0
X0X00000X0X0X000000X000X00
00X0000000XX00000000000000
00X0XX000X000000X000000000
15 8 5 7
1 25 14 14
2 1 10 22
15 14 5 22
8 3 2 8
12 9 17 21
17 23 9 11
9 20 11 11
12 11 2 11